GEN=Ensimmäinen Mooseksen kirja
EXO=Toinen Mooseksen kirja
LEV=Kolmas Mooseksen kirja
NUM=Neljäs Mooseksen kirja
DEU=Viides Mooseksen kirja
JOS=Joosua
JDG=Tuomarien kirja
RUT=Ruut
1SA=Ensimmäinen Samuelin kirja
2SA=Toinen Samuelin kirja
1KI=Ensimmäinen kuningasten kirja
2KI=Toinen kuningasten kirja
1CH=Ensimmäinen aikakirja
2CH=Toinen aikakirja
EZR=Esra
NEH=Nehemia
EST=Ester
JOB=Job
PSA=Psalmit
PRO=Sananlaskut
ECC=Saarnaaja
SNG=Korkea veisu
ISA=Jesaja
JER=Jeremia
LAM=Valitusvirret
EZK=Hesekiel
DAN=Daniel
HOS=Hoosea
JOL=Jooel
AMO=Aamos
OBA=Obadja
JON=Joona
MIC=Miika
NAM=Naahum
HAB=Habakuk
ZEP=Sefanja
HAG=Haggai
ZEC=Sakarja
MAL=Malakia
MAT=Evankeliumi Matteuksen mukaan
MRK=Evankeliumi Markuksen mukaan
LUK=Evankeliumi Luukkaan mukaan
JHN=Evankeliumi Johanneksen mukaan
ACT=Apostolien teot
ROM=Kirje roomalaisille
1CO=Ensimmäinen kirje korinttilaisille
2CO=Toinen kirje korinttilaisille
GAL=Kirje galatalaisille
EPH=Kirje efesolaisille
PHP=Kirje filippiläisille
COL=Kirje kolossalaisille
1TH=Ensimmäinen kirje tessalonikalaisille
2TH=Toinen kirje tessalonikalaisille
1TI=Ensimmäinen kirje Timoteukselle
2TI=Toinen kirje Timoteukselle
TIT=Kirje Titukselle
PHM=Kirje Filemonille
HEB=Kirje heprealaisille
JAS=Jaakobin kirje
1PE=Ensimmäinen Pietarin kirje
2PE=Toinen Pietarin kirje
1JN=Ensimmäinen Johanneksen kirje
2JN=Toinen Johanneksen kirje
3JN=Kolmas Johanneksen kirje
JUD=Juudaksen kirje
REV=Johanneksen ilmestys
